Type: WarwickMaze
Version: 1.0
Width: 31
Height: 31
HeaderEnd
###############################
#>....#.......#.#.......#...#.#
###.#####.#####.###.###.###.#.#
#...#.#.#...#.#...#.#.#.....#.#
###.#.#.#.###.#.#####.###.#.#.#
#...#.....#.........#.#.#.#...#
#.#.#.#.#.###.#.#####.#.###.###
#.#.#.#.#...#.#.....#.#...#...#
#.#######.#####.#####.#.###.###
#...........#...#.......#.#...#
#.###.#.#######.#######.#.#.###
#.#.#.#...#...#...#.#.........#
###.###.###.###.###.#####.###.#
#.#...........#...#.#.#...#.#.#
#.#######.#######.#.#.###.#.###
#...#...#.#.......#...#.......#
###.###.#.#######.###.###.###.#
#.........#.#...#.#.#.#.....#.#
###.#.#.#.#.###.#.#.#.#.###.###
#.#.#.#.#.........#.#...#.#.#.#
#.###########.###.#.###.#.###.#
#.....#...#.#.#...#.#...#.#.#.#
###.#####.#.#####.#.#.###.#.#.#
#...#.........#.......#...#...#
###.#########.###.###.###.###.#
#.................#.....#.#...#
#.#####.###.#.#.#.###.#.#.###.#
#.#.....#...#.#.#.#...#.....#.#
###.#.###########.#.#.#.###.#.#
#...#.#...........#.#.#.#....F#
###############################
